###########
#   # #   E
# ### # # #
# #   # # #
# # # # ###
#   # #   #
##### ### #
#     #   #
# ##### # #
# #     # #
# # # ### #
#   # # # #
# ##### ###
#     #   #
# ### # ###
# #   #   #
# # # ### #
S   #     #
###########
