#######################
#   #          #      #
# # ## ## ## # ## ## ##
# #    #   # #    #   #
# #### ### # #### ### #
#    # # ###    # # ###
### ####   ### ####   #
#        # #        # #
# #### ### # #### ### #
###    #   ###    #   #
S # #### # # # #### # #
#   #    # #   #    # #
############ ##########
#   #      #   #      #
# # ## ## ## # ## ## ##
# #    #   # #    #   #
# #### ###E# #### ### #
#    # # ###    # # ###
### ####   ### ####   #
#        # #        # #
# #### ### # #### ### #
###    #   ###    #   #
# # #### # # # #### # #
#   #    #     #    # #
#######################
