############################################### E
# #                                             #
# # ##########################################  #
# # #  # # # # # # # # # # # # # # # # # # # #  #
# # # ###########################################
# # # #    # # ### #   # # # ## ##   #    # ## ##
# # # #  # # #     # #        #    # # ## #  #  #
# # # #  # # #### ## ### # #  #  # #    #       #
# # # #  # # #     #   # ###  ## # # ############
# # # #  # # #  ###### # #            # # # #   #
# # # #  # # #  #    # # ###  ####### #       # #
# # # #  # # #  # ## # # #      #   # # #### ## #
# # # #  #   #         # # #  #   # #    #    # #
# # # #  ##############   ######### #############
# # # #                 S            # # # # ## #
# # # ####### # #### ##   ## ##### # # # # # ## #
# # # # # # # # #  # # # # # #     # # # # #  # #
# # # # # # # # #### ### # # ####### # # #  # # #
# # # # # # # #            #   #       # #  # # #
# # # # # # # ################ ###  #### #  # # #
# # # # # # #                  #       # #  # # #
# # # # # # #################### ##### # #  # # #
# # # # # #                    # #   # #    # # #
# # # # # ### # ############## #####   #### # # #
# # # # # # # # # # # # #    # #   # ###    # # #
# # # # # # # #   #   #    # # # # #   # #### # #
# # # # # # #   #   #   # #  #   # ### #    # # #
# # # # # ################# ###### #   #### # # #
#                                #   #          #
#################################################

