#####################################################################
#                                                          ###    ###
# ######  ##  ############################################ #### # ###
# #####        # ########                                  #### # ###
# ###### ## ####  #######        ###################### ####### # ###
#           ####  ######## ##### ###     #   ########## ####### # ###
# ######                ## ######### ### # # #          ####### # ###
# ############### #####    ##     ## ### # # # ################ # ###
#            #### #   # ##### ### ##  ## # #   ##########       # ###
############ #### # # # ##### ### ### ## # ### ########## ####### ###
############ #### # #   ##### ###     ## #   #                 ## ###
############ #### # ######### ########## ### ################# ## ###
############ #### #       ###        ###     ################# ## ###
#            #### # ################ ############################ ###
# ###############                             S#########          ###
# ######################## ############ ##########   ### ############
# #######                  ############ ########## # ### ############
#         ## ### ##### ### #####     E#   ######## # ### #####     ##
# #######                  ##### #######           # ### ##### ### ##
# ############# ################ ### ###############           ### ##
#                                ###            ################## ##
############### ################ ### ############################# ##
#                                #   ###                   ####### ##
# ############# ################## #####  ###############  ####### ##
#                                # #####                   ####### ##
######### ###################### # ##########       ############## ##
######### ######################                    ############## ##
######### ####                 ####### ######## ################## ##
######### #################### ####### ######## #                  ##
##                             ####### ######## # ###################
## ###### ######### ################## ######## # ###################
## ###### ######### ################## ######## # ###################
## ###### ######### ##################                   ############
## ######                                                ############
#   ##################################                   ############
#   ##################################                   ############
#####################################################################
